X,X,X,P,X
W,P,P,P,G
X,X,X,X,X
X,X,X,X,X
X,X,X,X,X